"filename", "language", "TypeScript", "JavaScript", "comment", "blank", "total"
"h:\Programming\Docs\nest\src\admin\admin.PrismaRepository.ts", "TypeScript", 32, 0, 0, 4, 36
"h:\Programming\Docs\nest\src\admin\admin.controller.ts", "TypeScript", 19, 0, 1, 4, 24
"h:\Programming\Docs\nest\src\admin\admin.module.ts", "TypeScript", 16, 0, 0, 2, 18
"h:\Programming\Docs\nest\src\admin\admin.repository.ts", "TypeScript", 6, 0, 0, 2, 8
"h:\Programming\Docs\nest\src\admin\admin.service.ts", "TypeScript", 18, 0, 0, 4, 22
"h:\Programming\Docs\nest\src\app.module.ts", "TypeScript", 18, 0, 0, 2, 20
"h:\Programming\Docs\nest\src\auth\auth.controller.ts", "TypeScript", 15, 0, 0, 4, 19
"h:\Programming\Docs\nest\src\auth\auth.module.ts", "TypeScript", 8, 0, 0, 2, 10
"h:\Programming\Docs\nest\src\auth\auth.service.ts", "TypeScript", 15, 0, 0, 3, 18
"h:\Programming\Docs\nest\src\auth\dto\auth.dto.ts", "TypeScript", 9, 0, 0, 3, 12
"h:\Programming\Docs\nest\src\auth\dto\index.ts", "TypeScript", 1, 0, 0, 1, 2
"h:\Programming\Docs\nest\src\constants\constants.ts", "TypeScript", 6, 0, 0, 1, 7
"h:\Programming\Docs\nest\src\csv\generate-csv.js", "JavaScript", 0, 263, 3, 1, 267
"h:\Programming\Docs\nest\src\csv\generate-csv.ts", "TypeScript", 152, 0, 3, 29, 184
"h:\Programming\Docs\nest\src\developer\developer.PrismaRepository.ts", "TypeScript", 114, 0, 3, 9, 126
"h:\Programming\Docs\nest\src\developer\developer.controller.ts", "TypeScript", 39, 0, 0, 8, 47
"h:\Programming\Docs\nest\src\developer\developer.module.ts", "TypeScript", 16, 0, 0, 2, 18
"h:\Programming\Docs\nest\src\developer\developer.repository.ts", "TypeScript", 10, 0, 0, 2, 12
"h:\Programming\Docs\nest\src\developer\developer.service.ts", "TypeScript", 30, 0, 0, 8, 38
"h:\Programming\Docs\nest\src\dto\admin.dto.ts", "TypeScript", 6, 0, 0, 1, 7
"h:\Programming\Docs\nest\src\dto\app.dto.ts", "TypeScript", 12, 0, 0, 2, 14
"h:\Programming\Docs\nest\src\dto\developer.dto.ts", "TypeScript", 7, 0, 0, 3, 10
"h:\Programming\Docs\nest\src\dto\index.ts", "TypeScript", 1, 0, 0, 1, 2
"h:\Programming\Docs\nest\src\dto\review.dto.ts", "TypeScript", 7, 0, 0, 2, 9
"h:\Programming\Docs\nest\src\dto\store.dto.ts", "TypeScript", 1, 0, 0, 1, 2
"h:\Programming\Docs\nest\src\dto\user.dto.ts", "TypeScript", 10, 0, 0, 3, 13
"h:\Programming\Docs\nest\src\main.ts", "TypeScript", 13, 0, 0, 2, 15
"h:\Programming\Docs\nest\src\prisma\prisma.module.ts", "TypeScript", 8, 0, 0, 2, 10
"h:\Programming\Docs\nest\src\prisma\prisma.service.ts", "TypeScript", 14, 0, 0, 2, 16
"h:\Programming\Docs\nest\src\store\store.module.ts", "TypeScript", 40, 0, 0, 4, 44
"h:\Programming\Docs\nest\src\store\storeAdmin\store.PrismaAdminRepository.ts", "TypeScript", 78, 0, 0, 10, 88
"h:\Programming\Docs\nest\src\store\storeAdmin\storeAdmin.controller.ts", "TypeScript", 39, 0, 0, 8, 47
"h:\Programming\Docs\nest\src\store\storeAdmin\storeAdmin.repository.ts", "TypeScript", 10, 0, 0, 2, 12
"h:\Programming\Docs\nest\src\store\storeAdmin\storeAdmin.service.ts", "TypeScript", 30, 0, 0, 8, 38
"h:\Programming\Docs\nest\src\store\storeDeveloper\store.PrismaDeveloperRepository.ts", "TypeScript", 81, 0, 0, 10, 91
"h:\Programming\Docs\nest\src\store\storeDeveloper\storeDeveloper.controller.ts", "TypeScript", 42, 0, 0, 8, 50
"h:\Programming\Docs\nest\src\store\storeDeveloper\storeDeveloper.repository.ts", "TypeScript", 10, 0, 0, 2, 12
"h:\Programming\Docs\nest\src\store\storeDeveloper\storeDeveloper.service.ts", "TypeScript", 30, 0, 0, 8, 38
"h:\Programming\Docs\nest\src\store\storeUser\store.PrismaUserRepository.ts", "TypeScript", 84, 0, 0, 10, 94
"h:\Programming\Docs\nest\src\store\storeUser\storeUser.controller.ts", "TypeScript", 39, 0, 0, 8, 47
"h:\Programming\Docs\nest\src\store\storeUser\storeUser.repository.ts", "TypeScript", 10, 0, 0, 2, 12
"h:\Programming\Docs\nest\src\store\storeUser\storeUser.service.ts", "TypeScript", 30, 0, 0, 8, 38
"h:\Programming\Docs\nest\src\user\user.PrismaRepository.ts", "TypeScript", 108, 0, 0, 17, 125
"h:\Programming\Docs\nest\src\user\user.controller.ts", "TypeScript", 40, 0, 0, 9, 49
"h:\Programming\Docs\nest\src\user\user.module.ts", "TypeScript", 16, 0, 0, 3, 19
"h:\Programming\Docs\nest\src\user\user.repository.ts", "TypeScript", 10, 0, 0, 2, 12
"h:\Programming\Docs\nest\src\user\user.service.ts", "TypeScript", 30, 0, 0, 9, 39
"Total", "-", 1330, 263, 10, 238, 1841